S X _ X _ X
_ _ _ _ _ X
_ X _ X X X
_ X _ _ _ X
_ _ _ X _ G